11111111
100111E1
10000101
10110101
10010001
11S11111